#######
#....L#
#....R#
#\*..\#
#######