#######
#\*..L#
#....R#####
#\*\......#
########.##
#\.......#
##########